4 3
   1   1   1   2
   1   0   1   2
   1   1   1   1
 
  -1  -1  -1 100
  -1   0  -1 -80
  -1  -1  -1  -1
